Hospital,Operations,Survivors,Deaths,ThirtyDaySurvival,PercentageDying
Bristol,143,102,41,71.3,28.7
Leicester,187,162,25,86.6,13.4
Leeds,323,299,24,92.6,7.4
Oxford,122,99,23,81.1,18.9
Guys,164,139,25,84.8,15.2
Liverpool,405,363,42,89.6,10.4
Southampton,239,215,24,90.0,10.0
Great Ormond St,482,429,53,89.0,11.0
Newcastle,195,169,26,86.7,13.3
Harefield,177,152,25,85.9,14.1
Birmingham,581,523,58,90.0,10.0
Brompton,301,270,31,89.7,10.3